R 1000 750

NO ./assets/xpm/no.xpm
SO ./assets/xpm/so.xpm
WE ./assets/xpm/we.xpm
EA ./assets/xpm/ea.xpm
S ./assets/xpm/sprite.xpm

C 153,204,255
F 255,204,153

        111111 111111111111111111
        1111111111111111111111111111111111111
        1000011100111100000000001
        1011000001110000000000001
        1001000000000110000000001
111111111011002001110111002000001
100000000011000001110100110111111
11110111211111011100010010001
11110111111111011101000010001
11000000110101011100000010001
100020E0000200001100100010001
10000000000000001101010010001
1100000111010101111101111000111
11110111 1110101 101111010001
11111111 1111111 1111111111111
00000000000000000000
000000000000
11111111111111111000000001111111
222222222222
