R 600 400 

NO ./path_to_the_north_texture
SO ./path_to_the_south_texture
WE ./path_to_the_west_texture
EA ./path_to_the_east_texture
S ./assets/xpm/sprite.xpm

C 153,204,255
F 255,204,153

        111111 111111111111111111
        1000011100111100000000001
        1011000001110000002000001
        100100000000010000000000111111111111111111111111111111
111111111011002001110100000000001
100000000011000001110100110111111
11110111211111011100010010001
11110111111111011101000010001
110000001101010111000N0010001000000000000000000000000000000000
1000200000020000110010001000100000000000000001    1 1 1 1 1 11
10000000000000001101010010001
1100000111010101111101111000111
11110111 1110101 101111010001
11111111 1111111 1111111111111
