R 320 200

NO ./assets/xpm/no.xpm
SO ./assets/xpm/so.xpm
WE ./assets/xpm/we.xpm
EA ./assets/xpm/ea.xpm
S ./assets/xpm/sprite.xpm

C 153,204,255
F 255,204,153 
     111111111111
	 	111
	11 	111		11
	11	111		11
	11	111	 N	11
	11	101		11
		111
	 11111111111	
	 
        111111 11111111111  11111
        100001110011000001  10001
        101100000111001111  10001
        100100000000001     10001
111111111011000001110011111110001
100000000011000001110101110111111
11110111111111011100000010001
11110111111111011101010010001
11000000110101011100000010001
10002000000000001100000010001
10000000000000001101010010001
11000001110101011111011110N0111
11110111 1110101 101111010001
11111111 1111111 111111111111
