R 1000 750

NO ./assets/xpm/no.xpm
SO ./assets/xpm/so.xpm
WE ./assets/xpm/we.xpm
EA ./assets/xpm/ea.xpm

S ./assets/xpm/sprite.xpm

C 153,204,255
F 255,204,153

111111111111111111111111
100000000000000000000001
102000000000000000000001
100200000000000000000001
100000111110000101010001
100000100010000100010001
100000100010000002200001
100000110110000101010001
100000110110000000000001
100000110000000000000001
100000000000000000000001
100020000000000000000001
100000000000000000000001
100000000000002000000001
100000000000000000000001
11111111100000N000000001
110100001000000000000001
110020101000000000000001
110100001000000000000001
110111111000000000000001
110000000000000000000001
111111111000000000000001
111111111111111111111111
