R 1920 1080

NO ./assets/xpm/goldenbutt.xpm
SO ./assets/xpm/goldenface.xpm
WE ./assets/xpm/redcatsky.xpm
EA ./assets/xpm/cat2.xpm
S ./assets/xpm/cleandogsprite.xpm

C 153,270,255
F 255,204,153

1111111111111111111111111
1000000000000000000001001
1020000000000000000001001
1002000000000000000001001
1000001111100001010101001
1000001000100001000101001
1000001000100000022001001
1000001101100001010101001
1000001101100000000001001
1000001100000000000001001
1000000000000000000001001
1000200000000000000001001
1000000000000000000001001
1000000000000020000001001
1000000000000000000001001
11111111100000N0000001001
1101000010000000000001001
1100201010000000000001001
1101000010000000000001001
1101111110000000000001001
1100000000000000000001001
1111111110000000000000001
1111111111111111111111111
