R 1280 820

NO ./assets/xpm/goldenbutt.xpm
SO ./assets/xpm/goldenface.xpm
WE ./assets/xpm/redcatsky.xpm
EA ./assets/xpm/cat2.xpm

S ./assets/xpm/cleandogsprite.xpm

F ./assets/xpm/woodenfloors.xpm
C ./assets/xpm/flower.xpm

111111111111111111111111
100000000000020000000001
102000000000000000000001
100200000000000000000001
100000111110000101010001
100000100010000100010001
1000001000100E0002200001
100000110110000101010001
100000110110000000000001
100000110000000000000001
100000000000000000000001
100020000000000020000001
100000000000000000000001
100000000000002000000001
100000000020000000000001
111111111000000000000001
110100001000000000000001
110020101000000000000001
110100001000000020000001
110111111000000000000001
110000000000000000000001
111111111000000000000001
111111111111111111111111
