R 600 600

NO ./assets/xpm/no.xpm
SO ./assets/xpm/so.xpm
WE ./assets/xpm/we.xpm
EA ./assets/xpm/ea.xpm
S ./assets/xpm/sprite.xpm

C 153,204,255
F 255,204,153

11111111
10000001
10000001
10000001
100W0001
11111111
